R 1920 1080
NO ./Textures/wood.xpm

111111   111111     
10001    100021
10001    10000111111     
10001111110000000001
10000000000000100001
11011101111111102011111
10010001   100000200021
10000001111100000000021
10100000000000001111111
10000000000000001
11101100011101101111
10110000000000001011
10000N11100111100001
10000110000000111101
10011100010000000001
10000000010011111011
11111110010000000001
   10000011120011001
   12000000000000001
   111111111111111111