R 1920 1080

111111   111111     
10001    100001
10001    10000111111     
10001111110000000001
10000000000000100001
10001111111100020001111
10000001   100000200021
10000001111100000000021
10100000000000001111111
10000000000000001
10100111111101111111
10111000000000001011
10000011100111100001
10000110000000111101
10011100000000000001
1N000000000011111011
11110000000010000001
   10000011110011001
   12000000000000001
   111111111111111111