
   

111111111111111     
100000000000001
10000000000000111111
10000000000000000001
10000000000000000001
10000000000000000001
10000000000000000001
10000000000000000001
10000000000000000001
10000000000000000001
10001111111101111011
11111000000000001011
10000011100111100001
10000110000000111101
10011100000000000001
10000000000011111011
11110000000010000001
   10000011110011001
   10000N00000000001
   11111111111111111