
   

1111111111
10000000001111
10000000001
10000000001
10000000001
10000W00001
10000000001
10000000001
10000000001
1111111111