
   

1111111111
100000   00001111
10000000001
10000000001
10000000001
100000 00001
1000000 0001
100000 00  001
10000000001
1111111111