
WE ./Textures/wood.xpm
C 150,180,255

R 1500 1000
   

111111   111111     
10001    100001
10001    10000111111
10001111110000000001
10000000000000000001
10001111111100100001111
10000001   100000000001
10000001111100000000001
11100000000000001111111
10000000002000001
11100111111101111111
11111000000000001011
10000011100111100001
10000110000000111101
10011100000000000001
10000000000011111011
11110000000010000001
   10000011110011001
   10000E00000002001
   11111111111111111